***************
*-------------*
*-------------*
*-------------*
*****---------*
*-------------*
*-------------*
*--------$----*
*------********
*-------------*
*-------------*
*---------^---*
******--------*
*-------------*
*-------------*
*---------$---*
*--------******
*-------------*
*-$$-----#----*
***************