***************
*-^-----------*
*-------------*
*-------------*
********------*
*-------------*
*-------------*
*--------$----*
*----**********
*-------------*
*-------------*
*-$-----------*
******--------*
*-------------*
*-------------*
*---------$---*
*--------******
*-++----------*
*+$$+----%----*
***************